 #########
 #   X   #
 # ## ## #
 #  X X  #
###  #  ###
#  .B#B.  #
# #  &  # #
#  .B#B.  #
###  #  ###
  #######